Pix | Caso deseje contribuir com um valor. Chave pix: 85989290648
Chaleira | Utensílio para ferver água rapidamente.
Gelágua | Aparelho para resfriar e servir água gelada.
Forno elétrico | Equipamento para assar, gratinar e aquecer alimentos.
Mixer | Aparelho portátil para misturar e triturar alimentos.
Mutiprocessador | Eletrodoméstico para cortar, triturar e processar alimentos.
Espremedor de laranja | Utensílio para extrair suco de laranjas.
Panela de pressão | Panela para cozinhar alimentos mais rápido com pressão.
Triturador de alho + pilão | Conjunto para triturar alho e temperos.
Armário | Móvel para armazenar utensílios e mantimentos.
Amolador de facas | Ferramenta para afiar lâminas.
Assadeiras | Peças para assar bolos, pães e outros alimentos.
Kit de bandejas | Conjunto para servir alimentos e bebidas.
Boleira de vidro | Peça para armazenar e servir bolos.
Cuscuzeira | Panela para preparo de cuscuz.
Fruteira | Recipiente decorativo e funcional para frutas.
Kit de Espátulas | Conjunto para manipular alimentos durante o preparo.
Escorredor de arroz+Escorredor de macarrão | Utensílios para escorrer arroz e massas.
Escorredor de louça | Peça para secar pratos, copos e talheres.
Kit de formas para bolo | Conjunto de formas para assar bolos.
Faqueiro | Conjunto de talheres para refeições.
Garrafa para café | Recipiente térmico para armazenar café quente.
Jarras para suco | Recipientes para servir sucos e bebidas.
Jogo de bowls | Conjunto de tigelas para servir ou preparar alimentos.
Jogo de copos de vidro | Conjunto de copos para bebidas.
Jogo de Canecas | Conjunto de canecas para café, chá ou leite.
Jogo de Frigideiras | Conjunto para fritar e grelhar alimentos.
Jogo de facas | Conjunto para corte de alimentos.
Jogo de Panelas | Conjunto de panelas para preparo de refeições.
Jogo de xicaras | Conjunto de xícaras para café ou chá.
Jogo de pratos | Conjunto de pratos para refeições.
Aparelho de jantar | Conjunto completo para servir refeições.
Kit utensílios de cozinha | Conjunto de utensílios para cozinhar.
Kit de peneiras + Molheira | Peneiras para coar e molheira para servir.
Kit de sousplats | Peças decorativas para apoio de pratos.
Kit potes herméticos | Recipientes com vedação para armazenar alimentos.
Porta temperos | Organizador para armazenar temperos.
Porta mantimentos | Recipientes para armazenar alimentos secos.
Jogo de sobremesa | Conjunto para servir sobremesas.
Ralador de alumínio + Tábua de corte | Utensílios para ralar e cortar alimentos.
Saladeira | Recipiente para servir saladas.
Tapetes | Peças para decoração e conforto.
Kit de taças | Conjunto de taças para vinhos e bebidas.
Tigelas | Recipientes para servir ou preparar alimentos.
Travessas | Peças para servir alimentos.
Almofadas para sofá | Peças para conforto e decoração.
Capas para almofada | Capas para proteger e decorar almofadas.
Manta para sofá ( grande) | Peça para cobrir e decorar o sofá.
Cortinas | Peças para decoração e controle de luz.
Mesa de Centro | Móvel de apoio para sala de estar.
Painel / Rack para TV | Móvel para suporte e organização de TV.
Cabeceira | Peça para encosto e decoração da cama.
Cobre leito Queen | Peça para cobrir e decorar cama Queen.
Edredons | Cobertores macios para aquecimento.
Espelho | Peça para decoração e uso pessoal.
Guarda roupa | Móvel para guardar roupas.
Jogo de cama Queen | Conjunto de lençóis e fronhas para cama Queen.
Lençol Casal | Lençol para cama de casal.
Travesseiros + Capa | Peças para apoio e conforto ao dormir.
Ventilador de coluna | Aparelho para ventilação do ambiente.
Capa para Colchão Queen | Protetor para colchão Queen.
Cesto para roupa | Recipiente para roupas sujas.
Escova para vaso + Lixeira Inox | Conjunto para higiene de banheiro.
Kit Lavabo | Conjunto decorativo e funcional para lavabo.
Kit toalha de banho e rosto | Conjunto de toalhas para higiene pessoal.
Aspirador de pó | Equipamento para limpeza de pisos e tapetes.
Bacias | Recipientes multiuso.
Baldes | Recipientes para transporte de líquidos.
Ferro de passar | Aparelho para passar roupas.
Tabua de passar | Superfície para passar roupas.

Máquina de lavar | Eletrodoméstico para lavar roupas.

